WWWWWWWWWWEEEEEEEEEEWWWWWWWWWW
WFFFBBFFFWEEEEEEEEEEWFFFFFFFFW
WFFBBFFFFWEEEEEEEEEEWFFLLLFFFW
WFBBFFFFFWWWWWWWWWWWWLLLLFFFFW
WFFFFWWFFFBFFFFFFFFBFFFFFFFBBW
WFFFFWWFFFBFFFFFFFFBFFFFFFFWWW
WFFFFFFFFWWWWWWWWWWWWFWFFFLLFW
WFFLLLFFFWEEEEEEEEEEWFWFBBLLFW
WFFFFFFFFWEEEEEEEEEEWFFFFFFFFW
WWWWWWWWWWEEEEEEEEEEWWWWWWWWWW