WWWWWWWWWW
WFFFLLFFFW
WFFFLLFFFW
WFFFBBFFFW
WFFFFFFFFW
WFFFFFFFFW
WFFFBBFFFW
WFFFLLFFFW
WFFFLLFFFW
WWWWWWWWWW